pos	ref_allele	alt_allele	ref	alt	vaf	tot	type
7	G	A	0	0	nan	0	none
8	G	C	0	0	nan	0	none
10	T	A	0	0	nan	0	none
21	C	T	3	0	0.0	3	none
40	C	T	50	0	0.0	50	none
66	C	T	129	0	0.0	129	none
90	G	A	115	0	0.0	115	none
97	A	G	124	0	0.0	124	none
111	T	C	137	0	0.0	137	none
120	T	C	144	0	0.0	144	none
121	C	T	145	0	0.0	145	none
140	C	T	168	0	0.0	168	none
186	C	A	193	0	0.0	193	none
187	A	G	196	1	0.005076142131979695	197	none
204	G	T	197	1	0.005050505050505051	198	none
210	G	T	203	0	0.0	203	none
211	T	C	205	0	0.0	205	none
241	C	T	1	199	0.995	200	clonal
285	G	T	130	55	0.2972972972972973	185	subclonal
313	C	T	171	0	0.0	171	none
374	G	A	192	0	0.0	192	none
376	G	T	199	1	0.005	200	none
379	C	A	201	0	0.0	201	none
380	T	G	201	0	0.0	201	none
388	G	T	187	1	0.005319148936170213	188	none
401	C	T	179	0	0.0	179	none
404	A	T	175	1	0.005681818181818182	176	none
482	C	T	193	23	0.10648148148148148	216	subclonal
490	T	A	223	0	0.0	223	none
527	C	T	223	0	0.0	223	none
558	G	T	108	107	0.49767441860465117	215	subclonal
565	T	C	222	0	0.0	222	none
595	T	G	219	0	0.0	219	none
613	G	A	199	0	0.0	199	none
660	G	T	100	47	0.3197278911564626	147	subclonal
663	G	T	113	39	0.2565789473684211	152	subclonal
679	C	T	139	1	0.007142857142857143	140	none
683	C	T	151	0	0.0	151	none
747	G	C	128	0	0.0	128	none
748	G	A	126	0	0.0	126	none
768	G	T	160	0	0.0	160	none
833	T	C	181	1	0.005494505494505495	182	none
884	C	T	177	4	0.022099447513812154	181	none
911	T	G	162	0	0.0	162	none
945	G	T	100	34	0.2537313432835821	134	subclonal
957	G	A	130	0	0.0	130	none
998	T	G	166	0	0.0	166	none
1015	A	G	177	0	0.0	177	none
1018	G	T	135	39	0.22413793103448276	174	subclonal
1059	C	T	1	195	0.9948979591836735	196	clonal
1060	C	T	203	2	0.00975609756097561	205	none
1076	C	T	221	0	0.0	221	none
1079	A	C	219	0	0.0	219	none
1080	A	T	222	0	0.0	222	none
1102	C	T	238	0	0.0	238	none
1115	A	G	238	0	0.0	238	none
1150	C	T	231	1	0.004310344827586207	232	none
1166	C	G	229	0	0.0	229	none
1181	G	T	216	15	0.06493506493506493	231	subclonal
1205	C	T	223	0	0.0	223	none
1308	A	G	176	0	0.0	176	none
1368	T	C	181	0	0.0	181	none
1379	G	C	187	0	0.0	187	none
1397	G	A	208	0	0.0	208	none
1403	C	T	195	0	0.0	195	none
1406	G	T	190	20	0.09523809523809523	210	subclonal
1427	C	T	217	1	0.0045871559633027525	218	none
1440	G	A	216	0	0.0	216	none
1460	A	G	227	0	0.0	227	none
1488	G	T	194	21	0.09767441860465116	215	subclonal
1515	A	G	199	1	0.005	200	none
1547	A	G	175	0	0.0	175	none
1572	C	T	154	0	0.0	154	none
1589	G	T	148	4	0.02631578947368421	152	none
1646	A	G	176	0	0.0	176	none
1676	G	T	212	0	0.0	212	none
1711	T	C	232	0	0.0	232	none
1723	T	C	237	0	0.0	237	none
1751	T	C	246	0	0.0	246	none
1787	A	G	236	0	0.0	236	none
1887	C	T	181	0	0.0	181	none
1899	G	T	192	10	0.04950495049504951	202	none
1912	C	T	200	1	0.004975124378109453	201	none
1914	G	A	197	0	0.0	197	none
1922	G	T	211	0	0.0	211	none
1929	C	T	204	0	0.0	204	none
2006	A	G	218	0	0.0	218	none
2036	G	T	164	68	0.29310344827586204	232	subclonal
2091	C	T	234	1	0.00425531914893617	235	none
2110	C	T	225	3	0.013157894736842105	228	none
2189	C	T	175	1	0.005681818181818182	176	none
2198	G	A	174	0	0.0	174	none
2416	C	T	221	1	0.0045045045045045045	222	none
2434	C	T	211	0	0.0	211	none
2446	T	C	206	1	0.004830917874396135	207	none
2455	C	T	198	1	0.005025125628140704	199	none
2470	C	T	190	0	0.0	190	none
2476	A	G	189	0	0.0	189	none
2480	A	G	190	0	0.0	190	none
2507	C	T	168	0	0.0	168	none
2523	C	T	194	5	0.02512562814070352	199	none
2528	G	A	189	0	0.0	189	none
2536	C	T	188	0	0.0	188	none
2558	C	T	192	0	0.0	192	none
2595	C	T	166	0	0.0	166	none
2604	G	T	108	62	0.36470588235294116	170	subclonal
2661	A	T	220	0	0.0	220	none
2702	T	G	233	0	0.0	233	none
2706	C	T	223	3	0.01327433628318584	226	none
2709	T	A	227	0	0.0	227	none
2713	A	C	225	0	0.0	225	none
2737	T	A	214	0	0.0	214	none
2749	C	T	216	1	0.004608294930875576	217	none
2769	G	C	174	0	0.0	174	none
2866	A	C	171	0	0.0	171	none
2868	T	A	166	0	0.0	166	none
2884	T	C	163	0	0.0	163	none
2891	G	A	162	0	0.0	162	none
2928	A	G	174	0	0.0	174	none
2992	T	C	215	1	0.004629629629629629	216	none
3004	G	T	111	97	0.46634615384615385	208	subclonal
3014	G	A	210	0	0.0	210	none
3037	C	T	0	197	1.0	197	clonal
3042	C	A	190	0	0.0	190	none
3096	C	T	184	1	0.005405405405405406	185	none
3099	C	T	186	0	0.0	186	none
3132	A	G	153	0	0.0	153	none
3165	C	T	164	0	0.0	164	none
3176	C	T	167	0	0.0	167	none
3177	C	T	169	1	0.0058823529411764705	170	none
3216	G	T	164	8	0.046511627906976744	172	none
3253	C	T	195	0	0.0	195	none
3259	G	T	178	26	0.12745098039215685	204	subclonal
3307	G	A	247	0	0.0	247	none
3373	C	A	241	0	0.0	241	none
3406	A	C	214	0	0.0	214	none
3411	C	T	208	0	0.0	208	none
3419	G	A	198	0	0.0	198	none
3479	G	T	168	4	0.023255813953488372	172	none
3520	T	C	122	1	0.008130081300813009	123	none
3551	C	T	102	13	0.11304347826086956	115	subclonal
3564	G	T	60	73	0.5488721804511278	133	subclonal
3625	A	C	182	1	0.00546448087431694	183	none
3634	C	T	185	0	0.0	185	none
3663	G	C	182	1	0.00546448087431694	183	none
3671	G	T	183	0	0.0	183	none
3784	C	T	150	0	0.0	150	none
3796	C	T	147	0	0.0	147	none
3839	G	A	146	1	0.006802721088435374	147	none
3871	G	T	170	4	0.022988505747126436	174	none
3896	G	T	171	30	0.14925373134328357	201	subclonal
3932	G	C	238	0	0.0	238	none
3977	G	T	243	0	0.0	243	none
4015	A	G	246	0	0.0	246	none
4052	C	T	212	2	0.009345794392523364	214	none
4071	C	T	202	0	0.0	202	none
4084	C	T	203	0	0.0	203	none
4180	G	A	201	0	0.0	201	none
4298	G	T	195	5	0.025	200	none
4301	C	T	201	0	0.0	201	none
4316	A	G	200	0	0.0	200	none
4400	C	T	227	0	0.0	227	none
4406	C	T	221	3	0.013392857142857142	224	none
4523	G	A	219	0	0.0	219	none
4540	C	T	221	0	0.0	221	none
4589	A	T	186	0	0.0	186	none
4633	C	T	141	0	0.0	141	none
4649	G	T	129	0	0.0	129	none
4683	C	T	133	2	0.014814814814814815	135	none
4698	C	T	139	1	0.007142857142857143	140	none
4776	C	T	216	0	0.0	216	none
4866	G	T	221	4	0.017777777777777778	225	none
4901	C	T	202	0	0.0	202	none
4908	G	T	141	54	0.27692307692307694	195	subclonal
4951	G	A	155	0	0.0	155	none
5156	G	T	173	14	0.0748663101604278	187	subclonal
5185	T	A	184	0	0.0	184	none
5196	G	T	155	16	0.0935672514619883	171	subclonal
5200	G	T	151	30	0.16574585635359115	181	subclonal
5211	C	T	167	0	0.0	167	none
5233	G	A	106	30	0.22058823529411764	136	subclonal
5348	C	T	11	0	0.0	11	none
5375	G	T	9	2	0.18181818181818182	11	none
5387	G	A	12	0	0.0	12	none
5453	G	A	16	0	0.0	16	none
5525	A	C	21	0	0.0	21	none
5544	C	T	18	0	0.0	18	none
5572	G	T	64	0	0.0	64	none
5617	G	T	137	24	0.14906832298136646	161	subclonal
5657	G	A	192	0	0.0	192	none
5784	C	T	232	0	0.0	232	none
5796	C	T	204	21	0.09333333333333334	225	subclonal
5847	G	T	151	37	0.19680851063829788	188	subclonal
5869	C	T	0	172	1.0	172	clonal
5880	G	T	122	65	0.34759358288770054	187	subclonal
5884	C	T	195	0	0.0	195	none
6032	G	A	218	0	0.0	218	none
6040	C	T	226	0	0.0	226	none
6079	T	C	221	1	0.0045045045045045045	222	none
6170	G	T	162	15	0.0847457627118644	177	subclonal
6260	A	G	206	0	0.0	206	none
6310	C	A	224	0	0.0	224	none
6312	C	A	226	0	0.0	226	none
6335	T	C	235	0	0.0	235	none
6359	G	T	221	17	0.07142857142857142	238	subclonal
6445	C	T	204	2	0.009708737864077669	206	none
6468	C	T	139	23	0.1419753086419753	162	subclonal
6483	G	T	153	48	0.23880597014925373	201	subclonal
6501	C	T	206	1	0.004830917874396135	207	none
6504	C	T	203	0	0.0	203	none
6528	A	C	207	0	0.0	207	none
6638	C	T	247	0	0.0	247	none
6668	T	A	250	0	0.0	250	none
6701	C	T	234	1	0.00425531914893617	235	none
6723	C	T	229	1	0.004347826086956522	230	none
6760	T	C	231	0	0.0	231	none
6804	G	T	167	55	0.24774774774774774	222	subclonal
6814	T	C	221	0	0.0	221	none
6855	C	T	222	1	0.004484304932735426	223	none
6867	A	G	201	0	0.0	201	none
6869	A	G	207	0	0.0	207	none
6945	T	C	220	0	0.0	220	none
6971	T	C	216	1	0.004608294930875576	217	none
6975	G	T	216	0	0.0	216	none
6977	G	A	218	0	0.0	218	none
6990	C	T	211	0	0.0	211	none
6996	T	C	202	0	0.0	202	none
7007	G	A	194	0	0.0	194	none
7011	C	T	189	1	0.005263157894736842	190	none
7017	G	T	109	62	0.36257309941520466	171	subclonal
7038	G	T	100	63	0.38650306748466257	163	subclonal
7042	G	T	164	0	0.0	164	none
7072	C	T	174	1	0.005714285714285714	175	none
7093	C	T	159	0	0.0	159	none
7128	G	A	158	0	0.0	158	none
7165	C	T	180	1	0.0055248618784530384	181	none
7214	G	T	159	33	0.171875	192	subclonal
7225	T	C	191	0	0.0	191	none
7334	C	T	175	0	0.0	175	none
7347	A	T	186	0	0.0	186	none
7355	C	T	198	0	0.0	198	none
7363	G	T	168	36	0.17647058823529413	204	subclonal
7382	C	A	207	0	0.0	207	none
7401	C	T	216	1	0.004608294930875576	217	none
7405	G	T	209	2	0.009478672985781991	211	none
7420	C	T	225	0	0.0	225	none
7438	T	C	238	0	0.0	238	none
7479	A	G	245	0	0.0	245	none
7507	A	C	247	0	0.0	247	none
7514	A	C	236	1	0.004219409282700422	237	none
7540	T	C	236	1	0.004219409282700422	237	none
7553	G	A	226	0	0.0	226	none
7579	T	A	202	0	0.0	202	none
7585	A	C	193	0	0.0	193	none
7732	C	T	215	1	0.004629629629629629	216	none
7786	A	T	246	0	0.0	246	none
7866	G	T	230	1	0.004329004329004329	231	none
7945	C	T	168	0	0.0	168	none
7953	A	G	169	0	0.0	169	none
8017	G	A	181	0	0.0	181	none
8024	G	T	181	1	0.005494505494505495	182	none
8025	C	T	181	1	0.005494505494505495	182	none
8027	G	T	178	6	0.03260869565217391	184	none
8062	A	T	221	0	0.0	221	none
8092	C	T	245	1	0.0040650406504065045	246	none
8102	G	T	241	6	0.024291497975708502	247	none
8111	G	A	240	0	0.0	240	none
8182	A	G	235	1	0.00423728813559322	236	none
8242	T	C	189	0	0.0	189	none
8286	T	C	224	0	0.0	224	none
8289	T	C	220	0	0.0	220	none
8359	T	C	214	0	0.0	214	none
8371	G	T	217	5	0.02252252252252252	222	none
8615	G	A	167	0	0.0	167	none
8628	A	T	182	0	0.0	182	none
8653	G	T	151	3	0.01948051948051948	154	none
8676	G	T	166	3	0.01775147928994083	169	none
8696	G	T	151	40	0.2094240837696335	191	subclonal
8782	C	T	227	1	0.0043859649122807015	228	none
8790	G	T	104	112	0.5185185185185185	216	subclonal
8884	A	T	198	0	0.0	198	none
8892	C	T	189	0	0.0	189	none
8950	C	T	201	0	0.0	201	none
9092	G	A	220	0	0.0	220	none
9129	T	C	219	0	0.0	219	none
9141	G	T	119	85	0.4166666666666667	204	subclonal
9170	C	T	196	1	0.005076142131979695	197	none
9180	C	T	186	0	0.0	186	none
9223	C	T	187	0	0.0	187	none
9249	G	T	154	47	0.23383084577114427	201	subclonal
9286	C	T	204	0	0.0	204	none
9307	A	G	227	1	0.0043859649122807015	228	none
9319	C	T	237	1	0.004201680672268907	238	none
9333	C	T	248	0	0.0	248	none
9389	G	T	239	3	0.012396694214876033	242	none
9430	C	A	234	0	0.0	234	none
9477	T	A	196	0	0.0	196	none
9561	C	T	223	1	0.004464285714285714	224	none
9655	T	C	244	0	0.0	244	none
9749	A	G	211	0	0.0	211	none
9803	C	T	181	0	0.0	181	none
9939	G	T	180	9	0.047619047619047616	189	none
9967	C	T	200	1	0.004975124378109453	201	none
10024	A	T	198	0	0.0	198	none
10038	C	T	185	1	0.005376344086021506	186	none
10081	A	G	147	0	0.0	147	none
10084	T	C	149	1	0.006666666666666667	150	none
10098	G	T	148	17	0.10303030303030303	165	subclonal
10102	T	C	175	0	0.0	175	none
10167	G	T	153	28	0.15469613259668508	181	subclonal
10252	C	T	223	1	0.004464285714285714	224	none
10265	G	A	215	0	0.0	215	none
10266	G	T	172	46	0.21100917431192662	218	subclonal
10350	C	T	180	0	0.0	180	none
10368	G	A	136	0	0.0	136	none
10422	C	T	194	0	0.0	194	none
10433	C	T	201	0	0.0	201	none
10480	T	C	200	0	0.0	200	none
10528	T	G	234	0	0.0	234	none
10712	C	T	206	3	0.014354066985645933	209	none
10754	G	T	164	40	0.19607843137254902	204	subclonal
10771	T	C	218	1	0.0045662100456621	219	none
10773	A	C	219	0	0.0	219	none
10779	T	A	224	0	0.0	224	none
10817	G	C	245	0	0.0	245	none
10851	C	T	243	0	0.0	243	none
10870	G	T	243	3	0.012195121951219513	246	none
10930	A	G	223	0	0.0	223	none
10956	C	T	203	0	0.0	203	none
10986	G	T	130	37	0.2215568862275449	167	subclonal
11058	C	T	220	0	0.0	220	none
11074	C	T	181	0	0.0	181	none
11077	T	C	170	0	0.0	170	none
11083	G	T	187	0	0.0	187	none
11089	A	G	196	0	0.0	196	none
11113	G	T	219	0	0.0	219	none
11131	T	A	234	0	0.0	234	none
11147	T	C	245	0	0.0	245	none
11148	T	C	244	0	0.0	244	none
11161	G	T	245	2	0.008097165991902834	247	none
11182	T	C	238	0	0.0	238	none
11195	C	T	238	0	0.0	238	none
11224	C	T	243	2	0.00816326530612245	245	none
11335	G	T	242	4	0.016260162601626018	246	none
11364	T	G	239	0	0.0	239	none
11376	G	T	231	6	0.02531645569620253	237	none
11410	G	A	217	0	0.0	217	none
11417	G	T	201	28	0.1222707423580786	229	subclonal
11418	T	C	230	1	0.004329004329004329	231	none
11454	C	A	246	0	0.0	246	none
11471	C	T	239	0	0.0	239	none
11511	C	G	239	0	0.0	239	none
11515	T	A	233	1	0.004273504273504274	234	none
11535	G	T	119	108	0.47577092511013214	227	subclonal
11562	G	C	212	0	0.0	212	none
11638	T	C	235	0	0.0	235	none
11669	C	A	235	0	0.0	235	none
11671	C	T	233	0	0.0	233	none
11737	T	C	239	0	0.0	239	none
11833	C	T	208	0	0.0	208	none
11849	A	G	195	0	0.0	195	none
11919	C	T	215	1	0.004629629629629629	216	none
11941	C	T	206	0	0.0	206	none
11943	A	G	193	0	0.0	193	none
11959	T	C	214	0	0.0	214	none
12041	G	T	185	50	0.2127659574468085	235	subclonal
12052	G	T	236	1	0.004219409282700422	237	none
12141	C	A	119	1	0.008333333333333333	120	none
12164	G	T	140	77	0.3548387096774194	217	subclonal
12274	G	T	241	0	0.0	241	none
12357	C	T	230	0	0.0	230	none
12398	C	T	189	0	0.0	189	none
12415	C	T	0	161	1.0	161	clonal
12478	G	A	212	0	0.0	212	none
12491	G	T	163	16	0.0893854748603352	179	subclonal
12565	G	A	247	0	0.0	247	none
12728	G	A	210	0	0.0	210	none
12741	C	T	230	0	0.0	230	none
12748	T	C	231	1	0.004310344827586207	232	none
12781	C	T	231	0	0.0	231	none
12809	C	T	197	0	0.0	197	none
12824	G	A	214	0	0.0	214	none
12863	G	A	246	0	0.0	246	none
12933	C	T	226	0	0.0	226	none
12970	C	T	203	2	0.00975609756097561	205	none
13024	A	G	216	0	0.0	216	none
13047	C	T	213	1	0.004672897196261682	214	none
13078	T	C	205	2	0.00966183574879227	207	none
13112	T	A	215	0	0.0	215	none
13118	G	T	214	4	0.01834862385321101	218	none
13126	G	A	217	0	0.0	217	none
13179	G	A	230	0	0.0	230	none
13193	G	T	204	26	0.11304347826086956	230	subclonal
13240	G	T	177	58	0.24680851063829787	235	subclonal
13280	C	T	214	0	0.0	214	none
13345	T	C	176	1	0.005649717514124294	177	none
13450	T	C	176	0	0.0	176	none
13452	C	A	179	0	0.0	179	none
13454	C	T	178	0	0.0	178	none
13506	C	T	173	0	0.0	173	none
13507	G	T	169	2	0.011695906432748537	171	none
13571	G	T	91	55	0.3767123287671233	146	subclonal
13627	G	T	176	2	0.011235955056179775	178	none
13687	G	T	203	0	0.0	203	none
13721	C	T	210	7	0.03225806451612903	217	none
13730	C	T	229	1	0.004347826086956522	230	none
13740	C	T	239	0	0.0	239	none
13850	G	T	174	40	0.18691588785046728	214	subclonal
13949	A	C	208	0	0.0	208	none
13951	A	T	208	0	0.0	208	none
13975	G	A	172	0	0.0	172	none
13990	C	T	161	0	0.0	161	none
14140	G	T	236	3	0.012552301255230125	239	none
14183	C	T	216	2	0.009174311926605505	218	none
14188	G	T	200	10	0.047619047619047616	210	none
14192	T	C	202	0	0.0	202	none
14198	C	T	195	1	0.00510204081632653	196	none
14224	A	G	218	0	0.0	218	none
14225	C	A	221	0	0.0	221	none
14277	G	T	137	78	0.3627906976744186	215	subclonal
14308	T	G	230	0	0.0	230	none
14313	T	C	236	0	0.0	236	none
14408	C	T	1	234	0.9957446808510638	235	clonal
14428	G	T	199	14	0.06572769953051644	213	subclonal
14536	C	T	118	37	0.23870967741935484	155	subclonal
14548	G	A	94	24	0.2033898305084746	118	subclonal
14555	T	C	172	0	0.0	172	none
14688	C	T	241	0	0.0	241	none
14712	G	A	244	0	0.0	244	none
14724	C	T	239	0	0.0	239	none
14786	C	T	232	0	0.0	232	none
14805	C	T	220	0	0.0	220	none
14877	C	T	192	1	0.0051813471502590676	193	none
14926	A	T	166	0	0.0	166	none
14935	G	T	171	1	0.005813953488372093	172	none
14968	G	C	194	0	0.0	194	none
15075	G	T	182	49	0.21212121212121213	231	subclonal
15095	A	C	232	0	0.0	232	none
15205	A	G	217	0	0.0	217	none
15222	C	T	194	0	0.0	194	none
15277	C	T	205	0	0.0	205	none
15324	C	T	246	1	0.004048582995951417	247	none
15359	G	A	238	1	0.0041841004184100415	239	none
15371	C	T	245	1	0.0040650406504065045	246	none
15540	C	T	205	3	0.014423076923076924	208	none
15579	C	T	207	1	0.004807692307692308	208	none
15607	T	C	243	0	0.0	243	none
15649	G	T	245	1	0.0040650406504065045	246	none
15677	A	G	243	0	0.0	243	none
15760	G	A	210	0	0.0	210	none
15769	G	T	97	91	0.48404255319148937	188	subclonal
15840	G	T	194	8	0.039603960396039604	202	none
15896	T	C	175	0	0.0	175	none
15898	G	T	175	1	0.005681818181818182	176	none
15900	T	C	179	0	0.0	179	none
15982	G	T	248	3	0.01195219123505976	251	none
16028	C	T	247	0	0.0	247	none
16068	G	T	173	44	0.20276497695852536	217	subclonal
16197	G	T	186	1	0.0053475935828877	187	none
16206	G	T	178	1	0.00558659217877095	179	none
16222	C	T	2	192	0.9896907216494846	194	clonal
16289	C	T	244	0	0.0	244	none
16381	G	A	208	0	0.0	208	none
16386	C	T	207	0	0.0	207	none
16432	G	T	176	1	0.005649717514124294	177	none
16466	C	T	170	4	0.022988505747126436	174	none
16498	C	T	136	3	0.02158273381294964	139	none
16508	G	T	111	25	0.18382352941176472	136	subclonal
16663	G	T	163	11	0.06321839080459771	174	subclonal
16665	G	T	183	2	0.010810810810810811	185	none
16733	C	T	162	0	0.0	162	none
16787	G	T	172	32	0.1568627450980392	204	subclonal
16848	C	T	221	0	0.0	221	none
16900	G	A	248	0	0.0	248	none
16995	C	T	238	4	0.01652892561983471	242	none
17089	G	T	221	1	0.0045045045045045045	222	none
17096	G	T	149	74	0.33183856502242154	223	subclonal
17104	C	T	236	0	0.0	236	none
17105	A	T	234	1	0.00425531914893617	235	none
17172	C	T	236	0	0.0	236	none
17180	A	G	241	0	0.0	241	none
17193	G	T	246	0	0.0	246	none
17226	T	C	247	0	0.0	247	none
17247	T	C	235	0	0.0	235	none
17288	C	T	244	0	0.0	244	none
17304	C	T	243	0	0.0	243	none
17339	C	T	202	0	0.0	202	none
17373	C	T	190	1	0.005235602094240838	191	none
17375	C	T	188	0	0.0	188	none
17539	G	A	230	0	0.0	230	none
17550	C	T	233	0	0.0	233	none
17562	G	T	235	4	0.016736401673640166	239	none
17569	C	T	234	2	0.00847457627118644	236	none
17615	A	G	224	0	0.0	224	none
17639	C	T	198	2	0.01	200	none
17688	T	C	182	0	0.0	182	none
17705	G	T	190	6	0.030612244897959183	196	none
17722	G	A	200	0	0.0	200	none
17730	A	T	210	0	0.0	210	none
17747	C	T	208	2	0.009523809523809525	210	none
17825	C	T	244	1	0.004081632653061225	245	none
17847	G	A	228	0	0.0	228	none
17848	G	T	175	39	0.1822429906542056	214	subclonal
17849	G	T	183	47	0.20434782608695654	230	subclonal
17858	A	G	246	0	0.0	246	none
17877	T	C	232	2	0.008547008547008548	234	none
17882	C	T	224	2	0.008849557522123894	226	none
17898	C	T	231	1	0.004310344827586207	232	none
17944	G	T	204	1	0.004878048780487805	205	none
17985	C	T	200	0	0.0	200	none
17993	A	G	193	0	0.0	193	none
18022	A	G	193	0	0.0	193	none
18060	C	T	170	1	0.005847953216374269	171	none
18086	C	A	187	0	0.0	187	none
18088	G	T	187	0	0.0	187	none
18170	G	T	173	34	0.1642512077294686	207	subclonal
18180	G	A	216	0	0.0	216	none
18213	G	T	205	0	0.0	205	none
18290	G	C	196	0	0.0	196	none
18297	G	T	135	57	0.296875	192	subclonal
18318	G	T	154	40	0.20618556701030927	194	subclonal
18331	A	T	197	0	0.0	197	none
18334	G	A	190	0	0.0	190	none
18337	G	T	184	0	0.0	184	none
18348	C	T	190	0	0.0	190	none
18354	A	C	193	1	0.005154639175257732	194	none
18381	T	C	226	0	0.0	226	none
18431	C	T	235	1	0.00423728813559322	236	none
18457	C	T	239	3	0.012396694214876033	242	none
18589	G	T	163	1	0.006097560975609756	164	none
18679	G	C	189	1	0.005263157894736842	190	none
18680	C	T	194	0	0.0	194	none
18685	T	C	192	1	0.0051813471502590676	193	none
18697	G	A	202	1	0.0049261083743842365	203	none
18723	T	C	228	2	0.008695652173913044	230	none
18736	T	C	240	0	0.0	240	none
18747	C	T	245	0	0.0	245	none
18750	T	C	249	0	0.0	249	none
18760	A	G	248	0	0.0	248	none
18763	A	T	248	0	0.0	248	none
18768	T	C	245	0	0.0	245	none
18795	C	T	244	1	0.004081632653061225	245	none
18814	C	T	244	1	0.004081632653061225	245	none
18816	G	C	237	0	0.0	237	none
18828	C	T	237	0	0.0	237	none
18877	C	T	195	0	0.0	195	none
18928	C	T	216	0	0.0	216	none
18974	T	A	169	0	0.0	169	none
18985	G	T	177	3	0.016666666666666666	180	none
19013	A	G	199	0	0.0	199	none
19065	T	C	223	0	0.0	223	none
19086	G	T	187	40	0.1762114537444934	227	subclonal
19175	A	G	205	0	0.0	205	none
19185	C	T	198	0	0.0	198	none
19218	T	C	166	2	0.011904761904761904	168	none
19252	G	T	127	55	0.3021978021978022	182	subclonal
19310	A	C	182	0	0.0	182	none
19337	A	G	195	0	0.0	195	none
19349	T	A	209	0	0.0	209	none
19366	C	T	216	2	0.009174311926605505	218	none
19480	G	T	149	41	0.21578947368421053	190	subclonal
19488	C	T	190	1	0.005235602094240838	191	none
19524	C	T	164	0	0.0	164	none
19555	T	C	132	0	0.0	132	none
19576	C	T	153	0	0.0	153	none
19586	C	T	175	1	0.005681818181818182	176	none
19679	G	T	182	37	0.1689497716894977	219	subclonal
19684	G	T	221	5	0.022123893805309734	226	none
19694	C	T	229	1	0.004347826086956522	230	none
19713	T	C	247	0	0.0	247	none
19763	C	T	242	0	0.0	242	none
19788	G	T	236	1	0.004219409282700422	237	none
19839	T	C	209	0	0.0	209	none
19862	C	T	203	0	0.0	203	none
19870	G	T	198	4	0.019801980198019802	202	none
19893	T	C	207	0	0.0	207	none
20098	G	A	205	0	0.0	205	none
20128	G	T	150	31	0.1712707182320442	181	subclonal
20221	C	T	159	1	0.00625	160	none
20233	C	T	173	0	0.0	173	none
20236	A	G	158	0	0.0	158	none
20237	G	T	157	3	0.01875	160	none
20240	G	A	167	0	0.0	167	none
20247	G	T	163	2	0.012121212121212121	165	none
20268	A	G	181	0	0.0	181	none
20281	T	C	197	0	0.0	197	none
20316	C	T	219	1	0.004545454545454545	220	none
20329	T	C	228	0	0.0	228	none
20352	G	C	233	0	0.0	233	none
20378	G	T	226	0	0.0	226	none
20445	T	C	204	0	0.0	204	none
20483	C	T	209	0	0.0	209	none
20560	G	T	192	3	0.015384615384615385	195	none
20564	C	T	193	0	0.0	193	none
20578	G	T	200	1	0.004975124378109453	201	none
20603	C	T	215	0	0.0	215	none
20647	C	A	231	0	0.0	231	none
20660	C	T	237	0	0.0	237	none
20703	C	T	247	0	0.0	247	none
20736	C	T	236	0	0.0	236	none
20742	A	G	233	0	0.0	233	none
20755	A	C	226	0	0.0	226	none
20773	G	A	210	0	0.0	210	none
20887	G	A	211	0	0.0	211	none
20931	G	T	235	0	0.0	235	none
21100	G	T	180	7	0.0374331550802139	187	none
21123	G	T	140	51	0.2670157068062827	191	subclonal
21137	A	G	194	0	0.0	194	none
21139	C	T	195	0	0.0	195	none
21147	T	G	191	0	0.0	191	none
21267	A	G	219	0	0.0	219	none
21301	C	A	212	0	0.0	212	none
21363	T	C	170	3	0.017341040462427744	173	none
21417	A	T	177	0	0.0	177	none
21567	T	C	223	0	0.0	223	none
21575	C	T	215	1	0.004629629629629629	216	none
21630	A	G	188	0	0.0	188	none
21642	C	T	173	0	0.0	173	none
21648	C	T	166	0	0.0	166	none
21710	T	C	196	1	0.005076142131979695	197	none
21711	C	T	197	0	0.0	197	none
21714	C	T	198	0	0.0	198	none
21728	T	C	188	0	0.0	188	none
21736	C	T	182	0	0.0	182	none
21789	C	T	235	0	0.0	235	none
21795	G	A	233	0	0.0	233	none
21855	C	T	241	1	0.004132231404958678	242	none
21898	G	T	230	0	0.0	230	none
21980	T	G	176	0	0.0	176	none
21998	C	T	171	0	0.0	171	none
22000	C	A	175	0	0.0	175	none
22018	G	T	140	31	0.18128654970760233	171	subclonal
22088	C	T	211	0	0.0	211	none
22127	C	T	237	0	0.0	237	none
22133	G	A	231	2	0.008583690987124463	233	none
22137	T	C	226	0	0.0	226	none
22176	C	T	229	0	0.0	229	none
22224	C	T	203	1	0.004901960784313725	204	none
22227	C	T	200	0	0.0	200	none
22257	G	T	135	39	0.22413793103448276	174	subclonal
22281	C	T	142	0	0.0	142	none
22303	T	G	127	0	0.0	127	none
22316	G	A	112	0	0.0	112	none
22323	C	T	96	1	0.010309278350515464	97	none
22326	C	T	91	0	0.0	91	none
22335	G	T	76	0	0.0	76	none
22338	C	T	72	0	0.0	72	none
22346	G	A	61	0	0.0	61	none
22357	T	C	72	0	0.0	72	none
22452	C	T	115	0	0.0	115	none
22468	G	T	117	1	0.00847457627118644	118	none
22480	C	T	114	0	0.0	114	none
22499	T	C	105	0	0.0	105	none
22509	C	T	101	0	0.0	101	none
22524	A	T	100	0	0.0	100	none
22623	A	G	186	0	0.0	186	none
22693	T	G	225	0	0.0	225	none
22709	T	C	228	0	0.0	228	none
22712	C	T	229	0	0.0	229	none
22735	C	T	226	1	0.004405286343612335	227	none
22754	G	T	216	0	0.0	216	none
22798	A	G	181	0	0.0	181	none
22838	C	T	145	0	0.0	145	none
22915	C	T	22	0	0.0	22	none
22918	G	T	21	0	0.0	21	none
22937	T	C	24	0	0.0	24	none
22955	G	T	23	0	0.0	23	none
22965	T	C	22	0	0.0	22	none
22992	G	C	28	0	0.0	28	none
23010	T	C	29	0	0.0	29	none
23016	G	T	25	5	0.16666666666666666	30	subclonal
23103	C	T	23	0	0.0	23	none
23126	G	C	17	0	0.0	17	none
23162	G	T	67	19	0.22093023255813954	86	subclonal
23206	C	T	153	0	0.0	153	none
23244	C	T	184	0	0.0	184	none
23288	G	T	186	17	0.08374384236453201	203	subclonal
23302	G	T	207	12	0.0547945205479452	219	subclonal
23332	T	C	226	0	0.0	226	none
23334	C	T	229	0	0.0	229	none
23335	T	A	227	0	0.0	227	none
23343	G	T	165	59	0.26339285714285715	224	subclonal
23403	A	G	0	203	1.0	203	clonal
23416	A	T	200	1	0.004975124378109453	201	none
23422	C	T	201	0	0.0	201	none
23423	C	T	201	0	0.0	201	none
23439	C	T	176	1	0.005649717514124294	177	none
23460	G	T	169	0	0.0	169	none
23505	G	T	151	10	0.062111801242236024	161	subclonal
23525	C	T	150	3	0.0196078431372549	153	none
23557	C	T	178	2	0.011111111111111112	180	none
23584	T	C	193	0	0.0	193	none
23593	G	T	186	12	0.06060606060606061	198	subclonal
23606	C	T	209	1	0.004761904761904762	210	none
23635	C	T	203	1	0.004901960784313725	204	none
23673	C	T	196	1	0.005076142131979695	197	none
23679	C	T	196	0	0.0	196	none
23699	G	C	192	1	0.0051813471502590676	193	none
23703	T	C	185	0	0.0	185	none
23707	C	T	180	3	0.01639344262295082	183	none
23747	G	T	150	8	0.05063291139240506	158	subclonal
23755	G	T	146	3	0.020134228187919462	149	none
23758	C	T	146	0	0.0	146	none
23766	C	T	102	27	0.20930232558139536	129	subclonal
23797	T	C	85	0	0.0	85	none
23816	C	T	113	0	0.0	113	none
23883	A	T	158	0	0.0	158	none
23929	C	T	206	0	0.0	206	none
23934	C	T	211	0	0.0	211	none
23965	T	A	224	0	0.0	224	none
23984	G	A	233	0	0.0	233	none
24026	C	T	213	0	0.0	213	none
24034	C	T	209	0	0.0	209	none
24040	G	T	185	19	0.09313725490196079	204	subclonal
24099	C	T	193	0	0.0	193	none
24121	A	G	183	0	0.0	183	none
24186	C	T	191	0	0.0	191	none
24236	G	T	218	3	0.013574660633484163	221	none
24325	A	G	216	0	0.0	216	none
24378	C	T	182	1	0.00546448087431694	183	none
24386	G	T	180	0	0.0	180	none
24395	C	T	169	1	0.0058823529411764705	170	none
24404	C	T	181	0	0.0	181	none
24433	A	G	171	0	0.0	171	none
24483	C	T	166	0	0.0	166	none
24508	A	G	192	0	0.0	192	none
24557	G	T	165	65	0.2826086956521739	230	subclonal
24579	C	T	239	1	0.004166666666666667	240	none
24585	T	C	242	0	0.0	242	none
24694	A	T	177	0	0.0	177	none
24707	C	T	196	0	0.0	196	none
24734	C	T	204	1	0.004878048780487805	205	none
24794	G	T	199	1	0.005	200	none
24797	C	T	200	0	0.0	200	none
24816	G	A	211	3	0.014018691588785047	214	none
24844	C	T	238	0	0.0	238	none
24847	T	A	238	0	0.0	238	none
24903	T	C	239	1	0.004166666666666667	240	none
24914	G	C	235	0	0.0	235	none
24933	G	T	78	140	0.6422018348623854	218	subclonal
25048	A	T	199	1	0.005	200	none
25049	G	T	199	1	0.005	200	none
25050	A	G	202	0	0.0	202	none
25080	A	C	186	0	0.0	186	none
25098	T	C	192	0	0.0	192	none
25132	C	A	215	0	0.0	215	none
25160	C	T	224	1	0.0044444444444444444	225	none
25174	A	C	232	0	0.0	232	none
25183	G	T	225	2	0.00881057268722467	227	none
25207	C	T	210	1	0.004739336492890996	211	none
25231	C	T	193	0	0.0	193	none
25250	G	T	177	4	0.022099447513812154	181	none
25292	C	G	156	0	0.0	156	none
25307	T	C	161	0	0.0	161	none
25319	T	A	124	0	0.0	124	none
25340	G	A	170	1	0.005847953216374269	171	none
25344	C	T	174	4	0.02247191011235955	178	none
25350	C	T	183	2	0.010810810810810811	185	none
25399	T	G	212	0	0.0	212	none
25413	C	T	236	2	0.008403361344537815	238	none
25429	G	T	245	1	0.0040650406504065045	246	none
25449	A	G	247	1	0.004032258064516129	248	none
25452	C	T	245	1	0.0040650406504065045	246	none
25473	T	C	240	0	0.0	240	none
25476	T	C	238	0	0.0	238	none
25500	G	T	234	2	0.00847457627118644	236	none
25521	C	T	227	2	0.008733624454148471	229	none
25528	C	T	218	0	0.0	218	none
25538	G	A	211	0	0.0	211	none
25552	G	T	193	2	0.010256410256410256	195	none
25563	G	T	0	186	1.0	186	clonal
25571	C	T	188	0	0.0	188	none
25572	C	T	188	0	0.0	188	none
25587	C	T	177	1	0.0056179775280898875	178	none
25593	G	C	172	0	0.0	172	none
25626	C	T	194	0	0.0	194	none
25644	G	T	167	1	0.005952380952380952	168	none
25673	T	C	129	0	0.0	129	none
25710	C	T	164	1	0.006060606060606061	165	none
25721	C	T	172	0	0.0	172	none
25725	A	G	175	0	0.0	175	none
25763	T	C	197	0	0.0	197	none
25820	C	A	201	0	0.0	201	none
25886	C	T	160	0	0.0	160	none
25916	C	T	171	0	0.0	171	none
25931	C	T	186	1	0.0053475935828877	187	none
25942	T	C	190	1	0.005235602094240838	191	none
25956	T	C	183	0	0.0	183	none
25968	A	G	182	0	0.0	182	none
25979	G	T	185	4	0.021164021164021163	189	none
26028	C	T	223	5	0.021929824561403508	228	none
26035	T	C	238	0	0.0	238	none
26088	C	T	243	0	0.0	243	none
26094	T	C	241	0	0.0	241	none
26102	T	A	241	0	0.0	241	none
26130	T	C	234	1	0.00425531914893617	235	none
26131	C	T	231	0	0.0	231	none
26144	G	T	226	2	0.008771929824561403	228	none
26211	G	T	199	2	0.009950248756218905	201	none
26262	G	C	209	4	0.018779342723004695	213	none
26326	C	T	217	0	0.0	217	none
26338	G	T	228	0	0.0	228	none
26370	C	T	244	0	0.0	244	none
26395	C	T	240	0	0.0	240	none
26398	G	A	241	0	0.0	241	none
26409	T	C	233	1	0.004273504273504274	234	none
26425	C	T	240	0	0.0	240	none
26439	G	T	233	1	0.004273504273504274	234	none
26447	C	T	232	0	0.0	232	none
26461	C	T	219	0	0.0	219	none
26464	C	T	209	1	0.004761904761904762	210	none
26499	C	T	176	0	0.0	176	none
26530	A	G	181	0	0.0	181	none
26558	G	T	197	3	0.015	200	none
26568	C	T	194	1	0.005128205128205128	195	none
26570	C	T	198	0	0.0	198	none
26625	C	T	212	1	0.004694835680751174	213	none
26681	C	T	245	1	0.0040650406504065045	246	none
26684	C	T	246	0	0.0	246	none
26713	G	T	244	0	0.0	244	none
26724	G	T	241	3	0.012295081967213115	244	none
26729	T	C	243	0	0.0	243	none
26818	C	T	182	0	0.0	182	none
26839	C	T	182	0	0.0	182	none
26842	G	T	187	0	0.0	187	none
26846	C	T	197	1	0.005050505050505051	198	none
26864	A	G	187	1	0.005319148936170213	188	none
26877	C	T	194	1	0.005128205128205128	195	none
26885	C	T	191	1	0.005208333333333333	192	none
26898	G	A	193	0	0.0	193	none
26907	C	T	167	0	0.0	167	none
26943	G	T	172	0	0.0	172	none
27033	G	T	198	21	0.0958904109589041	219	subclonal
27046	C	T	216	0	0.0	216	none
27163	G	T	203	5	0.02403846153846154	208	none
27179	G	T	206	2	0.009615384615384616	208	none
27217	G	T	184	1	0.005405405405405406	185	none
27233	T	C	209	0	0.0	209	none
27235	G	T	205	3	0.014423076923076924	208	none
27281	G	T	236	2	0.008403361344537815	238	none
27366	G	T	225	16	0.06639004149377593	241	subclonal
27384	T	C	236	0	0.0	236	none
27389	C	T	231	3	0.01282051282051282	234	none
27406	C	T	223	0	0.0	223	none
27493	C	T	225	3	0.013157894736842105	228	none
27500	C	T	232	0	0.0	232	none
27546	T	C	206	0	0.0	206	none
27559	C	T	216	2	0.009174311926605505	218	none
27600	C	T	237	2	0.008368200836820083	239	none
27602	G	T	216	21	0.08860759493670886	237	subclonal
27635	C	T	242	0	0.0	242	none
27654	C	T	239	1	0.004166666666666667	240	none
27676	G	T	222	8	0.034782608695652174	230	none
27688	C	T	230	0	0.0	230	none
27697	C	T	232	0	0.0	232	none
27727	C	T	222	0	0.0	222	none
27732	C	G	216	0	0.0	216	none
27804	C	T	194	0	0.0	194	none
27845	C	T	166	0	0.0	166	none
27911	C	T	220	1	0.004524886877828055	221	none
27923	C	T	231	0	0.0	231	none
27944	C	T	243	1	0.004098360655737705	244	none
27964	C	T	242	2	0.00819672131147541	244	none
27966	T	C	246	0	0.0	246	none
27971	T	C	245	0	0.0	245	none
27996	G	T	242	0	0.0	242	none
28028	G	T	236	0	0.0	236	none
28077	G	C	159	1	0.00625	160	none
28079	G	T	122	53	0.3028571428571429	175	subclonal
28086	G	T	97	63	0.39375	160	subclonal
28089	G	T	127	23	0.15333333333333332	150	subclonal
28093	C	T	192	0	0.0	192	none
28107	C	T	198	0	0.0	198	none
28137	T	C	182	1	0.00546448087431694	183	none
28144	T	C	176	0	0.0	176	none
28178	G	A	170	0	0.0	170	none
28183	G	A	179	0	0.0	179	none
28232	C	T	217	0	0.0	217	none
28233	G	T	217	0	0.0	217	none
28237	G	T	215	2	0.009216589861751152	217	none
28253	C	T	219	0	0.0	219	none
28311	C	T	221	1	0.0045045045045045045	222	none
28315	C	T	223	0	0.0	223	none
28338	A	G	190	1	0.005235602094240838	191	none
28346	G	T	183	6	0.031746031746031744	189	none
28357	G	T	174	2	0.011363636363636364	176	none
28368	G	T	174	3	0.01694915254237288	177	none
28378	G	T	161	1	0.006172839506172839	162	none
28451	G	C	151	0	0.0	151	none
28466	A	T	147	0	0.0	147	none
28468	A	T	149	0	0.0	149	none
28479	G	T	156	2	0.012658227848101266	158	none
28517	G	T	164	23	0.12299465240641712	187	subclonal
28528	C	T	197	1	0.005050505050505051	198	none
28557	G	T	194	8	0.039603960396039604	202	none
28559	G	T	150	55	0.2682926829268293	205	subclonal
28567	C	T	211	0	0.0	211	none
28583	C	T	210	1	0.004739336492890996	211	none
28603	C	T	211	1	0.0047169811320754715	212	none
28632	G	T	195	5	0.025	200	none
28638	C	T	202	1	0.0049261083743842365	203	none
28651	C	T	183	1	0.005434782608695652	184	none
28657	C	T	185	0	0.0	185	none
28659	G	A	184	0	0.0	184	none
28688	T	C	167	0	0.0	167	none
28690	G	T	171	0	0.0	171	none
28727	G	T	157	0	0.0	157	none
28736	G	T	141	1	0.007042253521126761	142	none
28743	T	C	142	0	0.0	142	none
28756	T	C	132	0	0.0	132	none
28786	C	T	110	0	0.0	110	none
28801	C	A	120	0	0.0	120	none
28805	G	A	120	0	0.0	120	none
28826	C	T	135	0	0.0	135	none
28842	G	T	132	3	0.022222222222222223	135	none
28853	T	G	140	0	0.0	140	none
28854	C	T	139	0	0.0	139	none
28861	T	C	136	0	0.0	136	none
28863	C	T	131	0	0.0	131	none
28866	C	T	133	0	0.0	133	none
28868	C	A	135	0	0.0	135	none
28871	G	A	134	0	0.0	134	none
28878	G	A	133	0	0.0	133	none
28881	G	A	136	0	0.0	136	none
28882	G	A	137	0	0.0	137	none
28883	G	C	135	0	0.0	135	none
28885	A	G	135	0	0.0	135	none
28887	C	T	135	0	0.0	135	none
28890	C	T	132	0	0.0	132	none
28896	C	G	134	0	0.0	134	none
28916	G	A	125	0	0.0	125	none
28963	T	A	105	0	0.0	105	none
28999	A	C	93	0	0.0	93	none
29002	C	T	100	0	0.0	100	none
29039	A	T	114	0	0.0	114	none
29085	C	T	139	2	0.014184397163120567	141	none
29095	C	T	139	4	0.027972027972027972	143	none
29119	C	T	177	0	0.0	177	none
29202	G	T	177	3	0.016666666666666666	180	none
29212	G	T	182	0	0.0	182	none
29215	C	T	182	0	0.0	182	none
29219	G	T	180	0	0.0	180	none
29247	C	T	167	1	0.005952380952380952	168	none
29253	C	T	167	0	0.0	167	none
29259	C	T	160	3	0.018404907975460124	163	none
29353	C	T	171	0	0.0	171	none
29395	G	C	164	0	0.0	164	none
29451	C	T	204	2	0.009708737864077669	206	none
29456	C	T	212	1	0.004694835680751174	213	none
29482	C	T	216	0	0.0	216	none
29509	C	T	218	3	0.013574660633484163	221	none
29514	C	A	223	0	0.0	223	none
29515	T	A	224	0	0.0	224	none
29517	A	G	225	0	0.0	225	none
29540	G	T	220	3	0.013452914798206279	223	none
29548	C	T	218	3	0.013574660633484163	221	none
29580	C	A	213	0	0.0	213	none
29585	C	T	209	0	0.0	209	none
29608	C	T	210	0	0.0	210	none
29614	C	T	206	1	0.004830917874396135	207	none
29625	C	T	198	0	0.0	198	none
29635	C	T	201	1	0.0049504950495049506	202	none
29640	C	T	201	0	0.0	201	none
29642	C	T	201	1	0.0049504950495049506	202	none
29679	C	T	178	0	0.0	178	none
29682	T	C	174	0	0.0	174	none
29683	A	G	174	0	0.0	174	none
29686	C	T	166	2	0.011904761904761904	168	none
29692	G	T	163	0	0.0	163	none
29700	A	G	157	3	0.01875	160	none
29706	G	T	147	3	0.02	150	none
29708	C	T	152	0	0.0	152	none
29724	C	T	127	1	0.0078125	128	none
29734	G	C	137	0	0.0	137	none
29739	C	T	136	0	0.0	136	none
29742	G	T	139	0	0.0	139	none
29743	C	T	139	0	0.0	139	none
29747	G	T	130	6	0.04411764705882353	136	none
29751	G	T	130	4	0.029850746268656716	134	none
29759	G	A	128	0	0.0	128	none
29774	C	T	120	0	0.0	120	none
29778	G	T	109	2	0.018018018018018018	111	none
29781	G	T	93	11	0.10576923076923077	104	subclonal
29792	A	G	100	0	0.0	100	none
29808	G	T	82	0	0.0	82	none
29825	G	A	63	0	0.0	63	none
29837	C	T	46	0	0.0	46	none
29857	C	T	0	0	nan	0	none
